Introduction
1
120
SSSSSSSSSSSSSSSSSSSSSSSSSSSSSSSSSSSSSSSS
STTTTTTRTTDTBRTTTTTBTBTTTTTTTRTTTTBTTTTS
STBPBTTTTTTRTTTTTTTTTBDTTBTTTTRTTTTTRTTS
STTTTTTTTTTRTTRTTTTTBTBTTBTTTTTTTTBTTTTS
SBTRRTTTTTTTTTBTTTTTTBTTBTTTTBTTTBTTTTTS
SBTBBTTTTTTTTTBBTTBTTTTTTTTBTTTTTTBTBRTS
STTTBTTBTTTTTTTTBTTTTTBTRBTTTTTTTTBTBBTS
SMMMMMMMMMMMMMMMMMMMMMMMMMMMMMMTTTBTTBTS
STRTTTBTTDTRTTBTBTTTTTTTTTTDTBRTTTTTTBTS
STTDTTTTTBTTTTTRTTTTTTTTBRRBTTTTTTTBTTTS
STTTBTTBTBTTTTTTTTTTTTTTBBTBTTBTTTTTTTTS
STRTTTTTBTTTTTTTTBBRTTTTTTTBTTBTDTTTTRTS
STBTTRTTBTRRTTTTTBTBDTTDTTTTBTTTBTTDTBTS
STDBTTTTTTTTTTTTTTBBBTTBTTTTTTTTDTTTTTBS
STTTTTTTTMMMMMMMMMMMMMMMMMMMMMMMMMMMMMMS
SRRTTTTTTTTTRTTTDTTTTBTTTTTBTTTBTTTTTTTS
SBRTTTTTTTTTBBTTBTTTTTTTTBTTTTTTBTBRTTTS
STBTTBTTTTTTTTBTTTTTBTRRTTTTDTTTBTBBTTTS
STTTTBDTTRTTTTTTTTBTTTTTTBTBDTTTTTTBTTTS
STTTRTTRTBTTBTBBTTTTTTTTTBTBDTTLTTTBTTBS
STDTTTTBTTTTTRTTTTTTTTTRTBTTBTTTTBTTTBTS
SSSSSSSSSSSSSSSSSSSSSSSSSSSSSSSSSSSSSSSS
