Rockfort
8
150
SSSSSSSSSSSSSSSSSSSSSSSSSSSSSSSSSSSSSSSS
STBTTBTTMTBTTTDTMTTTRTBTMRTTTTTTMTTBBTTS
STTTTTTTMTTTTTTRMRRTRTTTMRTTTTTTMTTTTRTS
SRRRRRRRRRRRRRRBRBBRRRRRRBRRDRRRRRRRRBRS
SDTTTTTTMTBTTTTBMTBTRTTRMTTBTTDTMTTBTBTS
STTTTTTTMTBTTTTBMTBTRRTTMTTTTTBTMTTTRTTS
SMMMMMMMMMMMMMMMMMMMRMMMMMMMMMMMMMMMMMMS
STTTTBBTMTTRTTTTMTTTRTTBMTTTRTTTMTTTTTTS
STTTTTTTMTTRTTTTMTTTRTTTMTTTBTTRMTTTTTBS
SRRRRRRRRRRBRRRRRRRRRRRRRRRRBRRRRRRRRRBS
SBTTBTTTMTTTTBTTMTTBBTTTMTTTTTTDMRTTTTTS
SBTTTTBTMTTBTTBTMTTTBTBBMTTTTTTTMBTTTBTS
STBTTRTTMTTTBTTTMTTTRTRRMTTTTTTTMBBTTBTS
SMMMMMMMMMMMMMMMMMMMRMMMMMMMMMMMMMMMMMMS
SBTERRTTMTTTTBTBMTTTRTTTMTBDTTRTMTTTTTTS
STTTTTRTMRTTTTTTMTTDRTTTMRTTRTBTMTRTRRTS
SRRRRRRRRBRRRRRRRRRRRRRRRRRRBRBRRRBRBBRS
SDTTRTBTMBTTTTBTMTBTRTTBMTBTBTTTMTTTTTTS
STTTTTBTMBTTDTTTMTTTRRTTMTTBTTTTMTTTRRRS
STDTTTBRMTTRTTTTMTPDRBTTMTRTTTTTMTTTBBBS
STBTTTTBMTTBTTBTMTLTRTTTMTTTTBTBMTTTTBTS
SSSSSSSSSSSSSSSSSSSSSSSSSSSSSSSSSSSSSSSS
