Labyrainté
15
200
SSSSSSSSSSSSSSSSSSSSSSSSSSSSSSSSSSSSSSSS
SBTMMTMBBTMTTTBMBTTBTTTTMTTTBTTTTTBMTDTS
STTPMTDTBTMTTTMMMTTMTBTTTTBTTBTBTTTMTMBS
STTTTMTTBDTTBTTTTMTTTTTBTMMBTTTTTTTMTMMS
SDTMTTMBMBTTBTTTTMTTTBTTTTTTBTBBTTTTTTBS
SBTMTTTMTTBTMMTTBTMMDTTTTTTTBTBBTTTTTTMS
SBBTTBTTTTMTTTBTTTTTTBTBBTTTTTTBTTDMMTTS
STTBTMMTTBTBBTTTMTTTTBTBBTTTTTTMTTBTMTBS
STTMTTTDTTTTTTDTBTTMMBTTBTMTMBTTMBTTDTBS
SBTBTTTTMTMMTBDTBTTMMBTTBTTDTMTTTMTTBTMS
STBTMMTTTTTBBMBTTDTMTMBTTMBTTTMBTTDTBTMS
SMTMMTTTTTTBBMBTTBTMTMBTTMBTTTTMMTTBTMMS
STMTBTBTMTTTMMBTTBTTTTMTTTBTTTTTMMTBTMMS
STMTBTBTMTDTMTMBTTMBTTTTBTTBTBBTTTTMTTTS
SMTTMBMBTTBTTTTMTTTDTTTMTBMTTTTTTMTMMTDS
SMTTTMMBTTMTDTTTMBTTBTBTTTBTMBTTTTTTMTTS
SMTDTTTTBTMMTTBTMMBTTTTTTTBTMBTTTTTTMTTS
STTBTTTTMTTTBTTTTTTBTBBTTTTTTMTTBTMTTTMS
SBTMMTTBTMMTTTMTTTTBTBBTTTTTTMTTBDTTBTTL
SMTTTBTTTTTTBTBDTTTTTTBTTTMMTTMBTTDTMTTS
SBBTTTMTTTTTBTBDTTTTTTMTTBTMDTDTBMTBTTTS
SSSSSSSSSSSSSSSSSSSSSSSSSSSSSSSSSSSSSSSS
