4 fantastiques
5
150
SSSSSSSSSSSSSSSSSSSSSSSSSSSSSSSSSSSSSSSS
SPTTTTTBTTTTTDTTTTTTTTTTTTTTBTTTTTTTTBTS
STTTTTBTTTTTTTTDTTTTTTTTTTTTTTTBTTTTDTTS
STTTTTTTTBTTTTTTTTTTTTTTTTTTTTTTTTTTTTTS
SBTTTTTTTTTTTTTTTTTTTTTTTTTTTTTTTTTTTTTS
STTTTTTTTTTTTTTTTTTBTTTTTTTTTTTTTTTTTTTS
STBTTTTTTTTTTTTTTTTTTTTBTTTTTTTTTTBTTTTS
STTBTTTTTBTTTTTTTTTTBTTBTTTTTDTTTTTTTTBS
STTTTTTBTTTTTBTTTTTTTTTTTTTTTTTTTTTTBTTS
STTTTTTTTRRTTBTTRRTTTTTTRRTTTTTTTRRTTTTS
STTTTTTTTERTTBTTERTTTTTTERTTTTTTTERTBTTS
STTTTTTTTTTTTTTTTTTTTTTTTTTTTTTTTTTTTTTS
STTTBTTTTTTTTTTTTTTTTTTTBTTTTTTTTTTTTTTS
STTTBTTTTTBTTTTTTTTTTTTTTTTTTDTTTTTTTTTS
STTTTTTBTTTTTTTTTTTBTTTTTTTTTTTTTTTTTTBS
STTTTTTTTTTTBTTTTTTTBTTTTTTTTTTTTTTTTTTS
STTBTTTTTTTTTTTTTTBTTTTTTTTTTTTTTTTTTTTS
STTTTTTDTTTTTTTTTTTTTTBTTTTTTTTTBTTTTTTS
STTTTTTTTTTTTTTTTTTTTTTTTTTTTTTTTBTTBTTS
STTTTBTTTTTTBTBBTTTTTTTTTTDTTTTTTTBTTTTS
STTTTTTTTTTTBTBBTTTTTTTTTBTTBTBTTTTTTTLS
SSSSSSSSSSSSSSSSSSSSSSSSSSSSSSSSSSSSSSSS
