Underwater
4
180
SSSSSSSSSSSSSSSSSSSSSSSSSSSSSSSSSSSSSSSS
SBTTTTTBBTTTTTTTBTPBRTTTTTTTBTTTTTTTTBTS
STTTTTBTBTTTTTTTTTTTTBDTTTBTTBTBTTTTTTTS
STTTDTTTTBTTBTTTTTTTTTTTTTTBTTTTTTDTTTTS
STTTTTTTTLTTTTTTTTTTTBTTTTTBBTTBTTTTTTTS
SBTTTDTTTTBTTTTTBTTTBTTTTTTTBTTBTTTTTTTS
STBTTBTTTTTTTTBTTTTTTBTBBTTTTTTTTTBTTTTS
STTBTTTTTBTTTTTTTTTTTBTBBTTTTTTTTTBTTTBS
STTTTTTTTTTTTTBTBTTTTBTTBTTTTTTTTBTTBTTS
SBTBTTTTTTTTTTBTBTTTTTTTDTTBTTTTTTTTTTTS
STTTTTTTTTTBBTBTTBTTTTBTTTBTTTTBTTBTBTTS
STTTTTTTTTTBTTBTTBTTTTTTTTTTTBTTTTTBTTTS
STTTBTBTTTTTTTBTTTTTTTTTTTBTTTTTTTTBTTTS
STTTBTBTTTBTTTTTTTTBTTTTTTTBTTTTTTTTTTTS
STTTTBTBTTBTTTTTTTTBTTTTTBTTTTTTTTTTTTBS
STTTTTTBTTTTBTTTTBTTBTBTTTTTTBTTTTTTTTTS
STTBTTTTTTTTTSSSSSSSSSSSSSSTTTTTTDTTTTTS
STTBTTTTTTTTTRRRRRRRRRRRRRRTTTTTTTTTTTTS
SBTTTTTDTTTTTBBBBBBBBBBBBBBTTTTTTTTTBTTS
STTTTTTTTTTTTTTTTTTTTTTTTTTTTTTTDTTTTTTS
STBTTTTTTTTTTTTTTTTTTTTTTTTTTTTTTTTBTTTS
SSSSSSSSSSSSSSSSSSSSSSSSSSSSSSSSSSSSSSSS
